# #################
#                 #
#### #####        #
#        #        #
#  #######        #
#                 O
###################